8 6
######
..##..
#.##.#
#.##.#
#.##.#
#.##.#
#....#
######
